-1 -1 -1 -1 -1 -1 -1 -1 -1 -1 -1 -1 -1 -1 -1 -1
-2 07 02 09 -5 07 02 02 09 -6 -6 -6 -5 -5 04 -4
-2 04 -5 04 -5 04 -6 -6 13 02 02 14 -5 -5 04 -4
-2 04 -5 04 -5 13 02 12 10 -5 02 15 02 02 14 -4
-2 -5 -5 04 -5 04 -9 04 -8 -8 -8 04 -6 -6 04 -4
-2 07 02 15 02 11 02 14 -8 -8 -8 13 12 02 10 -4
-2 04 -5 04 -6 -6 -6 13 02 02 02 11 14 -6 -6 -4
-2 04 -5 04 -9 03 02 14 -6 -6 -6 -6 13 09 -9 -4
-2 04 -5 08 12 03 -5 08 09 -5 07 02 15 11 09 -4
-2 04 -6 -6 04 -6 -5 -6 08 02 10 -5 04 -9 04 -4
-2 08 02 02 11 02 -6 -6 -6 -6 -6 -5 08 02 10 -4
-1 -1 -1 -1 -1 -1 -1 -1 -1 -1 -1 -1 -1 -1 -1 -1